NO textures/wall_1.xpm
SO textures/wall_2.xpm
WE textures/wall_3.xpm
EA textures/wall_4.xpm
F 184,113,39
C 51,198,227
111111
100101
101001
110001
1111011111111111111111111
1E00000000110000000000001
1011000001110000000000001
1001000000000000000000001
1111111111111111111111111
